00111111000
11111111110
11111111110
11111111110
11111111110
11111111110
11111111110
11111111110
11113311110
11113311110
00000000000