00000000000000000000000000000000
00000000000000000000000000000000
00111111000000000000000000000000
00111111000000000000011111000000
00111111000000000000111111000000
00111111000000000000111111000000
00111121000000000000111111000000
00111121000000000000122111000000
00000000000001111110122111000000
00000000000001111110000000000000
00000000000001111110000000000000
00000000000001111110000000000111
00000000000001111210000000000111
00000000000001111210000011111111
00000000000000000000000011111111
00000000000000000000000011111111
00000000000000000000000011111111
00000000000000000110000011111111
00000000000000000110000011122111
00000000000000000000000011122111
00111111000000000000000011122111
00111111000100000000000001100110
00111111000100000000000000000000
00111111000100000000000000000000
00121111000000000000000000000000
00121111000000000000000000000000
00000000000000000000000000000000
00000000000000000000000000000000
00000000000000000000000000000000
00000000000000000000000000000000
00000000000000000000000000000000
00000000000000000000000000000000
00000000000000000000000000000000