00000000001100011111
00111111001100111111
00111111001100111111
00111111000000111111
00111111000000112211
00121111000000112211
00121111000000000000
00000000000000000000
00000000000000110000
00000001111110110000
00000001111110000000
00000001111111000000
00010001111111000000
00000001111211000000
00000001111210000000
00000010000000000000
00000000000000000000
00000000000000000000
00000000000000000000
00000000000000000000
