0000000000000000000000000
0001111100000000000000000
0011111100001111110000000
0011111100001111110000000
0011111100001111110000000
0011221100001111110000000
0011221100001111210000000
0000000000001111210000000
0000000000000000000000000
0000000000000000000000000
0000000000000000111111000
0000000000000001111111100
0000000000000001111111100
0000000000000011111111110
0000000000000011122221110
0000000000000011122221110
0011111100000011100001110
0011111100000011100001110
0011111100000011100001110
0011111100000001100001100
0011112100000000000000000
0011112100000000000000000
0000000000000000000000000
0000000000000000000000000
0000000000000000000000000
